35
30
314,5,5,5,5,5,5,5,5,5,5,5,5,5,5,5,5,5,5,5,5,5,5,5,5,5,5,5,5,5,5,5,5,5
314,5,5,5,5,5,5,5,-41,5,5,5,5,5,5,5,5,5,5,5,5,5,5,5,5,5,5,5,5,5,5,5,5,5
314,314,314,314,5,5,5,5,5,5,5,5,5,5,5,5,5,5,5,5,5,5,5,5,5,5,5,5,5,5,5,5,5,5
5,5,5,314,314,314,314,314,314,314,314,314,314,314,5,5,5,5,5,5,5,5,5,5,5,5,5,5,5,5,5,5,5,5
5,5,5,5,5,314,5,5,5,5,5,5,5,314,5,5,5,5,5,5,5,5,5,5,5,5,5,5,5,5,5,5,314,314,314,314,314,314,314
5,5,5,5,5,314,5,5,5,5,5,5,5,314,314,314,5,5,5,5,5,5,5,5,314,314,314,314,314,314,314,314,314,5
5,5,5,5,5,314,5,5,5,5,5,5,5,5,5,314,5,5,5,5,5,5,5,5,314,5,5,5,5,5,5,5,5,5
5,5,5,5,5,314,314,5,5,5,5,5,5,5,5,314,314,314,314,314,314,314,314,314,314,5,5,5,5,5,5,5,5,5
5,5,5,5,5,5,314,5,5,5,5,5,5,5,5,5,5,5,5,5,5,5,5,5,5,5,5,5,5,5,5,5,5,5
5,5,5,-928,-929,-930,314,5,5,5,5,5,5,5,5,5,5,5,5,5,5,5,5,5,5,5,5,5,5,5,5,5,5,5
5,5,5,-936,-937,-938,314,5,5,5,5,5,5,5,5,5,5,5,5,5,5,5,5,5,5,5,5,5,5,5,5,5,5,5
5,5,5,-944,-945,-946,314,5,5,5,5,5,5,5,5,5,5,5,5,5,5,5,5,5,5,5,5,5,5,5,5,5,5,5
5,5,5,5,5,5,314,5,5,5,5,5,5,5,5,5,5,5,5,5,-8,-9,-41,5,5,5,5,5,5,5,5,5,5,5
5,5,5,314,314,314,314,5,5,5,5,5,5,5,5,5,5,5,5,5,-16,-17,5,5,5,5,5,5,5,5,5,5,5,5
5,5,5,314,5,5,5,5,5,5,5,5,5,5,5,5,5,5,5,5,5,5,5,5,5,5,5,5,5,5,-8,-9,5,5
5,5,5,314,5,5,5,5,5,5,5,5,5,5,5,5,5,5,5,5,5,5,5,5,5,5,5,5,5,5,-16,-17,5,5
5,5,5,314,5,5,5,5,5,5,5,5,5,5,5,5,5,5,5,5,5,5,5,5,5,5,5,5,5,5,5,5,5,5,5
5,314,314,314,314,5,5,5,5,5,5,5,5,5,5,5,5,-8,-9,5,5,5,5,5,5,5,5,5,5,5,5,5,5,5,5
314,314,5,5,314,5,5,5,5,5,5,5,5,5,5,5,5,-16,-17,5,5,5,5,5,5,-8,-9,5,5,5,5,5,5,5
5,5,5,5,314,314,314,5,5,5,5,5,5,5,5,5,5,5,5,5,5,5,5,5,5,-16,-17,5,5,5,5,5,5,5
5,5,5,5,5,5,314,5,5,5,5,5,5,5,5,5,5,5,5,5,5,5,5,5,5,5,5,5,5,5,5,5,-8,-9
5,5,5,5,5,5,314,5,5,5,5,-8,-9,5,5,5,5,5,5,5,5,5,5,5,5,5,5,5,5,5,5,5,-16,-17
5,5,5,-41,5,5,314,5,5,5,5,-16,-17,5,5,5,5,5,5,5,5,5,5,-5,5,5,5,5,5,5,5,5,-8,-9
5,5,5,5,5,5,314,5,5,5,5,5,5,5,5,5,5,5,5,5,5,5,5,5,5,5,5,5,5,5,5,5,-16,-17
5,5,5,5,5,5,314,5,5,5,5,5,5,5,5,5,5,5,5,-41,5,5,5,5,5,5,5,5,5,5,5,5,-8,-9
314,5,5,5,5,5,314,5,5,5,5,5,5,5,5,5,5,5,5,5,5,5,5,5,5,5,5,5,5,5,5,5,-16,-17
314,5,5,5,5,5,314,5,5,5,5,5,5,5,-8,-9,5,5,5,5,5,5,5,5,5,5,-8,-9,-8,-9,-8,-9,-8,-9
314,314,314,314,314,314,314,5,5,5,5,5,5,5,-16,-17,5,5,5,5,5,5,5,5,5,5,-16,-17,-16,-17,-16,-17,-16,-17
314,5,5,5,5,5,5,5,5,5,5,5,5,5,-8,-9,5,5,-8,-9,-8,-9,-8,-9,-8,-9,-8,-9,-8,-9,-8,-9,-8,-9
314,5,5,5,5,5,5,5,5,5,5,5,5,5,-16,-17,5,5,-16,-17,-16,-17,-16,-17,-16,-17,-16,-17,-16,-17,-16,-17,-16,-17
